111111111111111111111
100010001000100010001
100010001000100010001
100010001000100010001
111111111111211111112
100010001000100010001
100010001000100010001
100010001000100010001
111111111111111111111
100010001000100010001
100010001000100010001
100010001000100010001
111121111111211111111
100010001000100010001
100010001000100010001
100010001000100010001
111111111111111111112
100010001000100010001
100010001000100010001
100010001000100010001
111121111111111121111