11111111211111112
10001000100010001
10001000100010001
10001000100010001
11111111111121111
10001000100010001
10001000100010001
10001000100010001
21111111211111112
10001000100010001
10001000100010001
10001000100010001
11112111111121111
10001000100010001
10001000100010001
10001000100010001
21111111211111111